aang = kakak
abah = bapak
abdi = saya
abot = berat
acan = belum
acuk = pakaian
adat = tabiat
adeuk = akan
adi = adik
adigung = angkuh
adil = adil
agan = tuan
ageung = besar
agul = bangga
agul =  sombong
aheng = aneh
aheng = ganjil
aing = saya
ajag = serigala
ajeng = mengajukan
ajleng = lompat
akang = kakak
akar = akar
aki = kakek
aksara = tulisan
aksara = huruf
ali = cincin
alim = tidak mau
alit = kecil
almenak = almanak
alo = keponakan
alung = lempar
alus = bagus
amang = paman
amarah = emosi
ambeh = agar
ambek = marah
ambekan = hawa nafsu
ambeu = mencium bau
ambu = ibu
ameng = bermain
amis = manis
ampar = tilam
ampir = hampir
ampir = nyaris
anak = anak
ancin = sedikit makan
anclub = turun ke air
ancur = hancur
andiprek = lesesan
anduk = handuk
angel = bantal
anggel = bantal
angger = tetap
anggo = pakai
anggoan = pakaian
angkat = pergi
angkeng = pinggang
angkeub = mendung
angkeut = dagu
anjang = mengunjungi
anjeun = anda
anjeun = kamu
anjeunna = dia
anjeunna = ia
anjeunna = beliau
anom = muda
antawis = antara
anteur = antar
antos = tunggu
antuk = akhirnya
antukna = akhirnya
anu = Yang
anyar = baru
aos = baca
apa = bapak
apal = hafal
api-api = pura-pura
aprak = jelajah
apu = batu kapur
arek = akan
areung = arang
arit = celurit
artos = uang
asa = sepertinya
asak = masak
asak = matang
asin = asin
astana = pekuburan
astra = wajah
asup = masuk
atah = mentah
atanapi = atau
atawa = atau
ateul = gatal
atik = ajar
atik = didik
atikan = ajaran
atoh = senang
atos = sudah
atra = jelas
awak = badan
awak = tubuh
awang-awang = angkasa
awewe = perempuan
awewe = wanita
awi = bambu
awis = mahal
awon = jelek
aya = ada
ayak = saring
ayakan = saringan
ayeuna = kini
ayeuna = sekarang
babar = lahir
babaturan = teman
badag = besar
bade = akan
bagean = bagian
bagel = keras
bagja = bahagia
bagong = babi hutan
baham = mulut
baheum = kulum
bahe = tumpah
baheula = dahulu
bajing = tupai
bakal = akan
balad = teman
balanak = belanak
balang = lempar
balangsak = melarat
balangsak = miskin
baledog = lempar
baleg = dewasa
baleuy = tidak terlalu panas
balik = pulang
balong = kolam
balung = tulang
bancet = katak berekor
bangga = ribet
bangir = mancung
bangkawarah = kurang ajar
bangke = bankai
bangkong = katak
bangkuang = bengkuang
bango = bangau
bantos = bantu
bantun = bawa
baraya = saudara
bared = tergores
bareuh = bengkak
bari = basi
baruk = begitukah
barusuh = sariawan
basa = bahasa
basa = ketika
basa = saat
baseuh = basah
basisir = pesisir
bati = laba
batur = orang lain
bau = bau
bawa = bawa
bayah = paru-paru
bayawak = biawak
bayeungyang = gerah
bayuhyuh = gemuk
beak = habis
beas = beras
bebene = kekasih
bedegong = bandel
bedil = senjata laras panjang
bedog = golok
begal = perampok
begang = kurus
beha = bra
beja = kabar
beja = berita
beke = pendek
bekong = mug besar
belegug = bodoh
belegug = tolol
belejog = tipu
kabelejog = tipu
belenyeh = tertawa kecil
belesek = amblas
belet = bodoh
bencong = waria
bendu = marah
bener = benar
bengkok = lengkung
bengkok = melengkung
bengkung = bongkok
bengkung = lengkung
bentang = bintang
bentar = sambar
benten = beda
bere = beri
mere = memberi
berehan = sopan
beresih = bersih
beresin = bersin
berkat = bingkisan
beuheung = leher
beulah = belah
beuleum = bakar
beuli = beli
beulit = lilit
beungeut = wajah
beunghar = kaya
beungkeut = ikat
beurang = siang
beurat = berat
beureum = merah
beurit = tikus
beusi = besi
beuteung = perut
bewara = berita
biang = ibu
biantara = pidato
bieu = barusan
bikang = betina
bilatung = belatung
binangkit = kreatip
bingah = gembira
bingah = geraham
bingung = kalut
bireuk = tidak kenal
bisluit = surat keputusan
bitis = betis
bitu = meledak
biwir = bibir
bobo = tidur
bobo = lapuk
boboko = bakul
bobos = kentut
bobotoh = pendukung
bodas = putih
bodo = bodoh
bodor = lawak
boga = punya
bojo = isteri
boloho = bodoh
bolokot = kotor oleh lumpur
bongoh = lengah
bosen = bosan
buah = mangga
budah = buih
budak = anak
bueuk = burung ahntu
bujal = udel
bujangan = jejaka
bujur = pantat
buk-bak = obrak-abrik
buktos = bukti
buku = buku
bulan = bulan
bulao = biru
buleud = bulat
bumi = rumah
bungah = gembira
buni = tersembunyi
buntut = ekor
bureuteu = gendut
buru = lekas
buruan = halaman rumah
buruh = upah
burung = gila
butuh = perlu
butut = jelek
buyur = anak katak
caah = banjir
caang = terang
cabak = raba
cabok = tampar
cacag = cincang
cadu = tak pernah
cagak = cabang
cageur = sehat
cai = air
cakcak = cecak
caket = dekat
calacah = abu rokok
calakan = rajin
calana = celana
caletot = keceplosan ngomong
kacaletot = keceplosan ngomong
calik = duduk
candak = ambil
candak = bawa
cangcang = tambat
cangked = tambat
cangkeng = pinggang
cangkurileung = burung kutilang
cape = lelah
capit = jepit
caram = larang
carang = jarang
carek = larang
careham = geraham
carengcang = jarang
careuh = musang
caringin = beringin
carios = cerita
carita = cerita
carita = kisah
caroge = suami
carpon = cerpen
cawet = celana dalam
cekap = cukup
ceker = kaki
cempor = lampu minyak
cenang = bisul
cengek = cabai rawit
cengkat = bangun
centang = sentil
cepil = telinga
cerewed = cerewet
ceudeum = mendung
ceuk = kata
ceuli = telinga
ceumpal = lap
ceurik = tangis
ceurik = menangis
ciak = anak ayam
ciduh = ludah
cikur = kencur
cilaka = celaka
cileuh = belek
cileuh = kotoran mata
cingceng = gesit
cingcin = cincin
cingir = kelingking
cingogo = jongkok
cipruk = basah
ciri = tanda
citak = cetak
ciwit = cubit
cobi = coba
coet = cobek
cokor = kaki
cokot = ambil
colok = jotos
comel = banyak omong
comot = mengambil sedikit
congcorang = belalang sembah
coplok = lepas
coplok = terlepas
cucuk = duri
cucunguk = kecoa
cukang = jembatan
cunihin = genit
cupu = kotak
cureuleuk = jeli
cureuleuk = berbinar
curuk = jari telunjuk
dadali = burung garuda
daek = mau
dago = tunggu
dahar = makan
dahuan = kakak ipar
dalapan = delapan
damang = sehat
damar = lampu
damel = kerja
damis = pipi
dampal = telapak
dangdan = rias
dangdos = rias
danget = saat
dangu = dengar
darehdeh = ramah
datang = sampai
datang = tiba
datang = sampai
dayeuh = kota
deet = dangkal
denge = dengar
deudeuh = sayang
deui = lagi
deukeut = dekat
deuleu = lihat
deungeun = teman
deungeunna = lauk pauk
dewek = saya
diajar = belajar
digjaya = sakti
dina = di
dina = pada
dines = dinas
dinten = hari
diuk = duduk
doja = coba
doja = ganggu
domba = biri-biri
dongkap = sampai
dongkap = tiba
du'a = do'a
dudukuy = topi
dugi = tiba
duit = uang
duka = tidak tahu
dulur = saudara
dumasar = berdasarkan
dunungan = majikan
dunya = dunia
dupak = senggol
duriat = perasaan cinta
duruk = bakar
eces = jelas
edeg = stress
edeg = gila
edeg = pandir
ee = beol
ekek = burung betet
eleh = kalah
eleketek = gelitik
elmu = ilmu
emang = paman
embe = kambing
embung = tidak mau
empang = kolam
emut = ingat
endah = indah
endeur = bergetar
endog = telur
enggal = cepat
enggeus = sudah
engke = nanti
enjing = besok
enjing = pagi
enjing-enjing = pagi-pagi
entog = bebek
entong = jangan
enya = iya
era = malu
etang = hitung
etangan = hitungan
eueut = minum
eujeung = dengan
euleum = cukup
eunteung = cermin
euntreup = hinggap
eurad = jerat
eureun = berhenti
eusi = isi
gabrug = terkam
gado = dagu
gaduh = punya
gajih = lemah
galengan = pematang sawah
galeuh = beli
galing = ikal
galumbira = bergembira
galungan = gumul
galungan = bergumul
galur = jalan
gampang = mudah
gampil = mudah
gampleng = tampar
gancang = cepat
gandeng = berisik
gantar = galah
ganti = ganti
gapura = gerbang
garing = kering
garo = garuk
garong = pencuri
garwa = istri
gawe = kerja
gawir = jurang
gayor = sangga
gayot = gantung
gede = besar
gedong = gedung
gegel = gigit
geheng = hangus
gehgeran = latah
geleng = gilas
geleng = lindas
gelo = gila
gelut = berkelahi
gembul = lahap
genep = enam
gentos = ganti
gepok = tumpuk
gering = sakit
gero = panggil
ngageroan = memanggil
getek = geli
geter = getar
getih = darah
getok = jitak
getol = rajin
geugeut = sayang
geulang = gelang
geuleuh = jijik
geulis = jelita
geumpeur = gugup
geuneuk = lebam
geunjleung = tersiar
geutah = getah
gigir = sebelah
gigir = samping
gimir = jerih
girimis = gerimis
gitek = goyang
giwang = anting
godog = rebus
gogog = an-jing
gohgoy = batuk
goreng = jelek
gorobag = gerobak
gugah = bangun tidur
gugunungan = bukit
gugusi = gusi
guguyon = humor
guha = goa
gula = gula
guludug = guntur
gumbira = gembira
gumbira = girang
gumilang = gemilang
gumujeng = ketawa
gundam = gigau
gurilap = gemerlap
halabhab = dahaga
halabhab = haus
halimpu = merdu
halimun = kabut
halis = alis
halodo = musim kering
halu = alu
hambar = tawar
hampang = ringan
hampas = ampas
hamperu = empedu
hampura = maaf
hanaang = dahaga
hanaang = haus
handap = bawah
handap = rendah
haneut = hangat
hanjakal = menyayangkan
hanjelu = sesal
hanyir = amis
hapa = hampa
hapunten = mohon maaf
harangasu = jelaga
haratis = gratis
harep = harap
hareudang = gerah
hareup = depan
harewos = bisik
hariring = dendang
hariwang = cemas
harkat = martabat
harti = arti
hartos = arti
haseum = asam
haseup = asap
haur = bambu
hawek = loba
hayam = ayam
hayang = mau
hayang = kepingin
hayu = ayo
hayu = mari
he es = tidur
hejo = hijau
hemeng = heran
henteu = tidak akan
herang = bening
herang = jernih
hese = susah
heu euh = iya
heubeul = dahulu
heulang = elang
heuleut = saat
heureut = menyempit
heureuy = gurau
hideng = rajin
hidep = kamu
hideung = hitam
hideung lestreng = hitam legam
hieum = rindang
hiji = satu
hilap = lupa
hileud = ulat
hilik = awas
hilir = ilir
hipu = empuk
hipu = lunak
hirup = hidup
hitut = kentut
honcewang = bimbang
hoream = malas
hoyong = mau
hoyong = ingin
huut = gabah
hudang = bangun tidur
hudang = bangkit
huis = uban
hujan = hujan
hulu = kepala
huma = ladang
huntu = gigi
hurang = udang
hurung = nyala
hutang = utang
hyang = dewa
sanghyang = dewa
ibak = mandi
iber = kabar
ibing = menari
ibu = ibu
ibun = embun
ical = jual
ical = hilang
icip = cicip
idek = didekatkan
ieu = ini
iga = rusuk
igel = menari
ijid = jijik
ilahar = normal
imah = rumah
imbit = pantat
impleng = membayangkan
imut = senyum
incer = incar
incok = encok
incu = cucu
indit = pergi
indung = ibu
inget = ingat
inggis = gelisah
ingkab = ketiak
ingkab = ketek
ingkig = pergi meninggalkan
ingon = ternak
injeum = pinjam
injuk = ijuk
inohong = tokoh
inteun = intan
ipis = tipis
iraha = kapan
irong = lihat
irung = hidung
ised = geser
isin = malu
istenan = memperhatikan
isteri = wanita
isteri = perempuan
isuk = besok
isuk = pagi
isukan = besok
isuk-isuk = pagi-pagi
itu = itu
itung = hitung
iuh = teduh
iwal = kecuali
jaga = kelak
jagjag = sehat
jagong = jagung
jail = jahil
jajaka = jejaka
jajaka = jpemuda
jajaten = ilmu kesaktian
jalma = manusia
jalma = orang
jalmi = manusia
jalmi = orang
jalu = jantan
jampana = joli
jampe = mantera
janari = pagi buta
jandela = jendela
jangar = pusing
janggot = janggut
jangjang = sayap
jangji = janji
jangkorang = tinggi kurus
jangkrik = jangkrik
jangkung = tinggi
janten = jadi
japati = merpati
jaram = kuman
jarhiji = jari manis
jarum = jarum
jatra = jelas
jauh = jauh
jawer = janger ayam
jempling = sepi
jempling = sunyi
jempol = ibu jari
jenengan = nama
jero = dalam
jeung = dan
jibreg = basah kuyup
jiga = seperti
jilid = jilid
jiwa = jiwa
jugjug = tuju
jujuluk = gelar
jujur = jujur
jumblah = jumlah
jumpalit = salto
jungkrang = jurang
juntrung = menjadi
juragan = tuan
juralit = salto
jurig = hantu
juru = sudut
ka = ke
kadieu = ke sini
kaditu = ke sana
kabeh = semua
kabentar = tersambar
kabiri = kebiri
kabogoh = kekasih
kaca = halaman
kacida = amat sangat
kade = awas
kadek = sambit
kadongdong = kedongdong
kadongkapan = kedatangan
kaduhung = menyesal
kaen = kain
kagoda = tergoda
kagungan = punya
kahatur = kepada
kai = kayu
kajabi = kecuali
kajajaden = jejadian
kakandungan = hamil
kalangkang = bayangan
kalapa = kelapa
kaleng = aping
kaler = utara
kalih = juga
kalong = kelelawar
kamar = kamar
kamari = kemarin
kampak = kapak
kampungan = norak
kandel = tebal
kanggo = untuk
kangkalung = kalung
kanyaho = pengetahuan
kaos sangsang = singlet
kaping = tanggal
ping = tanggal
kapungkur = dahulu
kaput = jahit
karang = tahi lalat
karaton = istana
kareueut = manis sekali
kareunang = gerah
karunya = kasian
karunya = iba
kasetrum = tersengat listrik
kasuat-suat = teringat-ingat
katel = wajan
katuhu = kanan
kaula = saya
kawas = seperti
kawasa = kuasa
kawentar = mashur
kawih = lagu
kawilang = terbilang
kawit = berasal
kawon = kalah
kawung = enau
kayas = pink
kayas = merah muda
kebon = kebun
kecap = kalimat
kedul = pemalas
kelek = keliak
kelek = ketek
kelenci = kelinci
kelir = warna
kelir = corak
kembang = bunga
kempel = kumpul
kempelan = perkumpulan
kenca = kiri
kenging = dapat
kentel = kental
kenteng = genteng
kenyed = hentak
kenyot = isap
keok = kalah
kerek = mendengkur
kerekeb = terkam
kerepus = topi
keretas = kertas
kersa = mau
kersa = sanggup
kesang = keringat
kesed = sepat
kesed = sepet
keuheul = jengkel
keuheul = geram
keukeuh = memaksa
keukeup = peluk
keuneung = tumit
keupeul = genggam
keureut = iris
keusik = pasir
keuyeup = kepiting sawah
kiat = kuat
kiceup = kedip
kidul = selatan
kieu = begini
kiih = kencing
kila-kila = tanda-tanda
kinca = cairan gula aren
kinten = kira
kinten-kinten = kira-kira
kintun = kirim
kirang = kurang
kiridit = kredit
kiripik = keripik
kiruh = keruh
kitu = demikian
kitu = begitu
kiwa = kiri
kiwari = sekarang
kiwari = kini
kobok = memasukan tangan
koceak = jerit
kojor = meninggal
kojor = mati
kolor = celana dalam
kolot = tua
komo = apa lagi
konci = kunci
koneng = kunyit
koneng = kuning
kongkorong = kalung
kored = kais
koret = kikir
koret = pelit
korong = upil
koropak = bagian dari
koropok = berlubang
koropos = keropos
korsi = kursi
kosok = gosok
ku = oleh
kuar = anak kutu rambut
kuciwa = kecewa
kudu = harus
kueh = kue
kukupu = kupu-kupu
kulah = kolam
kulambu = kelambu
kulawarga = keluarga
kulawargi = keluarga
kulem = tidur
kulon = barat
kulub = rebus
kulutus = gerutu
kumaha = bagaiman
kumbah = cuci
kumeli = kentang
kumis = kumis
kunaon = kenapa
kuncen = juru kunci
kunyit = jawawut
kunyuk = kera
kuping = dengar
kurang = kurang
kuring = saya
kuris = cacar
kuru = kurus
kurung = kandang burung
kurupuk = kerupuk
kusir = kusir
kusumah = kesuma
kutang = bra
kuya = kura-kura
laat = telat
lada = pedas
lahan = tanah
lain = bukan
lajeng = selanjutnya
lajeng = kemudian
laki rabi = suami istri
lalab = lalap
lalaki = laki-laki
laleur = lalat
lali = lupa
laluasa = leluasa
lambar = lembar
lambey = bibir
lami = lama
lamokot = belepotan
lamot = jilat
lampah = jalan yang ditempuh
lamping = pinggir gunur
lampuyang = lempuyang
lamun = jika
lamun = bila
lana = abadi
lanceuk = kakak
lancingan = celana
landong = obat
langgam = lagu
langit = langit
langki = langka
langkung = lebih
langlang = langlang
ngalanglang = melanglang
langlayangan = layang-layang
lantaran = karena
lantera = lentera
lauk = ikan
laun = lambat
lawas = lama
lawon = kain
layad = jenguk
layat = jenguk
layeut = selalu bersama
layon = kain
layung = lembayung
leeh = mencair
lebar = sayang
lebet = masuk
lebu = abu gosok
ledis = habis tidak tersisa
lega = luas
lega = lebar
leketek = gelitik
lekoh = kental
lelepen = cincin
leleson = istirahat
lemah cai = tanah air
lembur = desa
lembur = kampung
lemes = halus
lempeng = lurus
lengkah = langkah
lenglang = cerah
lengoh = tidak bawa apa-apa
lentah = lintah
leot = setrika
lepat = salah
leres = benar
leres = betul
lesot = lepas
letah = lidah
letak = jilat
letoy = lemah
leuit = lumbung
leuleus = lemas
leumeung = lemang
leumpang = jalan
leungeun = tangan
leungit = hilang
leungit = lenyap
leupeut = lontong
leutak = lumpur
leutik = kecil
leuweung = hutan
leuweung geledegan = hutan rimba
leuwi = kolam pemandian
leuwi = lubuk
leuwih = lebih
liang = lobang
liat = alot
lieuk = toleh
lieur = pusing
lila = lama
lilir = bangun tidur
lima = lima
limpeuran = lupa
limpeuran = pelupa
lindeuk = jinak
linggih = tinggal
linggih = berdiam di
linggih = duduk
lini = gempa
lintuh = gemuk
lisa = telur kutu rambut
lisung = alu
loba = banyak
lonceng = bel
lodaya = harimau
loket = dompet
lolong = buta
lomari = lemari
londok = bunglon
longok = kunjung
losin = lusin
ludes = habis tidak tersisa
ludeung = berani
luhung = tinggi
luhur = tinggi
luhur = atas
luhureun = diatas
lukut = lumut
lumangsung = terjadi
lumpat = lari
luncat = loncat
lungguh = pendiam
lungsur = turun
madu = madu
maehan = membunuh
maenya = masa
mahiwal = janggal
mahiwal = tidak mungkin
majeng = maju
maksad = maksud
maksad = hasrat
makuta = mahkota
malengpeng = lempar batu
males = malas
maling = pencuri
mamang = paman
mana = mana
manah = hati
manawi = barangkali
manawi = jika
mandi = mandi
maneh = kamu
maneh = engkau
manehna = dia
manehna = ia
mangga = silakan
manggu = manggis
manggul = pikul
mangkukna = kemarin lusa
mangrupa = berupa
mangsa = saat
mangsi = tinta
mantep = mantap
manuk = burung
maot = meninggal dunia
margi = karena
masang = pasang
masih = masih
mastaka = kepala
matak = membuat
matak = akan
matang = seimbang
mateni = membunuh
maung = harimau
mayit = mayat
medit = kikir
melak = tanam
mencrang = berkilau
mengkol = belok
mengpar = lempar
menta = minta
meong = harimau
meri = itik
meri = bebek
meser = membeli
metot = tarik
meumpeun = menutup mata
meunang = menang
miceun = buang
mieling = mengenang
milu = ikut
mimiti = mulai
minantu = menantu
mindeng = sering
mindeng = kerap
mios = berangkat
mios = pergi
mitoha = mertua
modol = beol
mojang = gadis
mojang = perempuan
molelel = asin sekali
moncorong = terik
mondok = tidur
mondok = inap
mongkleng = gulita
mo-nyet = kera
moro = buru
motekar = kreatip
muhun = iya
muka = buka
mulih = pulang
mumuncangan = mata kaki
muncrat = mancur
munding = kerbau
mung = cuma
mung = hanya
munggaran = pertama
murag = jatuh
murangkalih = anak kecil
muriang = demam
muringkak = merinding
mutu = ulekan
mutuskeun = memutuskan
naek = naik
namba = menimba
nam = nama
namung = tetapi
nangkarak = terlentang
nangkring = nongkrong
nangkring = mejeng
nangkuban = telungkup
nangtung = berdiri
naon = apa
narpati = raja
nawis = menawar
neda = makan
nembe = baru saja
nembe = barusan
nene = nenek
nerekel = panjat
ngabagel = mengeras
ngabolekerkeun = membuka rahasia
ngadeg = berdiri
ngadegdeg = menggigil
ngadegkeun = mendirikan
ngagaleong = oleng
ngageol = bergoyang
ngagitek = menari
ngahodhod = menggigil
ngajleng = melompat
ngalamun = melamun
ngalangkung = lewat
ngapung = terbang
ngaran = nama
ngarasa = merasa
ngareuah-reuah = menyemarakan
ngarogahala = membunuh
ngawitan = mulai
ngenaan = mengenai
ngendong = menginap
ngeunah = ngeunah
ngijih = musim hujan
ngimpleng = mengingat
nginum = minum
ngomong = bicara
ngora = muda
ngorondang = merangkap
nincak = injak
nikah = kawin
ningal = lihat
ningal = melihat
nini = nenek
notog = meluncur
notog = todong
nu = Yang
nuju = sedang
numpak = menaiki
nyaah = sayang
nyaeta = ialah
nyaeta = Yaitu
nyaho = tahu
nyakclak = titik air
nyalukan = panggil
nyalukan = memanggil
nyambat = memanggil
nyangkrung = menggenang
nyangsang = tersangkut
nyaram = melarang
nyarek = melarang
nyarios = bicara
nyere = lidi
nyeri = sakit
nyeuneu = berapi-api
nyeureud = menyengat
nyeuseuh = mencuci baju
nyiksenan = menyaksikan
nyiruan = lebah
nyiwit = cubit
nyongcolang = terbaik
nyumput = sembunyi
nyuruput = meminum
nyuruput = seruput
oge = juga
ogo = manja
olo-olo = kolokan
olok = kebanyakan
ombak = gelombang
ondang = undang
ondangan = undangan
ongkoh = katanya
ongkos = tarip
opat = empat
oray = ular
orok = bayi
pacabakan = pegangan
pacabakan = pekerjaan
pacilingan = wc di atas kolam
pacul = cangkul
padaharan = perut
paeh = meninggal
paeh = mati
pageto = besok lusa
pahatu = piatu
pahatu lalis = Yatim piatu
pait = pahit
pajaratan = kuburan
pakarangan = halaman rumah
pake = pakai
palangkakan = selangkangan
palastik = plastik
palay = mau
palid = hanyut
paling = curi
palu = palu
palu = martil
pamajikan = isteri
pamarentah = pemerintah
pameget = laki-laki
pameunteu = wajah
panangan = tangan
panata harta = bendahara
panceg = teguh
pancen = tugas
paneunggeul = pemukul
pangambung = hidung
panganten = pengantin
pangaos = harga
panitik = penitih
panon = mata
panonpoe = matahari
panto = pintu
pantrang = tak pernah
panyawat = penyakit
paok = curi
papada = sesama
papah = jalan
papatong = capung
papay = telusuri
papendak = bertemu
parabot = peralatan
paranti = untuk
parantos = sudah
paras = cukur
parawan = perawan
pareum = padam
paria = pare
parin = memberikan
parin = serah
parung = jeram
pasagi = persegi
pasanggiri = lomba
pasea = bertengkar
pasini = janji
pasir = bukit
pasisian = kota pinggiran
patali = berkaitan
patlot = pensil
patuangan = perut
patut = tampang
pawon = dapur
payun = depan
pecut = cambuk
pedes = lada
pegek = pesek
pek = silakan
pelak = menanam
pelak = tanam
pelem = gurih
pelesir = piknik
pelong = tatap
pelor = peluru
pendak = bertemu
pengker = belakang
pengkol = belok
mengkol = membelok
pengkolan = belokan
pengpar = larikan ke sebelah
peot = kurus
percanten = percaya
perhatosan = perhatian
perkara = hal
perkara = perihal
perkawis = hal
perkawis = perihal
persaben = tukang minta-minta
peryogi = perlu
pesak = saku
pesek = kupas
peser = beli
peso = pisau
pestol = pistol
peuncit = gorok
peunteun = nilai
peura = serak
peura = parau
peureum = pejam
peureut = peras
peurah = bisa ular
peurih = pedih
peuting = malam
peuyeum = tape
pi = bakal
pias = pudar
piceun = buang
pidang = menampilkan
piding = sekat
piit = pipit
pikeun = untuk
pikeun = teruntuk
pilari = cari
pilih = memilih
pinarep = payudara
pingping = paha
pingpong = tenis meja
pinton = tayang
pinter = pintar
pipir = samping rumah
pirak = cerai
piraku = masa
pireu = bisu
pisan = sangat
pisan = amat
pisan = sekali
poe = hari
poe = jemur
poek = gelap
poho = lupa
pondok = pendek
pribados = pribadi
pribados = saya sendiri
pribumi = tuan rumah
pulisi = polisi
pulpen = ballpoin
pun buang = ibu
punten = maaf
punten = permisi
pupuhu = pemimpin
pupuhu = ketua
pupus = mati
pupus = meninggal dunia
pupus = hapus
purun = jadi
purunyus = genit
puseur = tengah
putra = anak
rada = agak
ragaji = gergaji
ragrag = jatuh
raheut = luka
rahul = bohong
rahul = bohong
rajin = giat
raka = kakak
raket = intim
raksukan = baju
rama = bapak
rambut = rambut
rame = ramai
ramo = jari
rampak = gabung
rampak = bersama-sama
rampung = beres
rampus = rakus
ranca = rawa
rancucut = basah kuyup
randa = janda
randa bengsrat = janda kembang
ranggeum = cengkram
rangu = renyah
raos = enak
raraosan = perasaan
raray = wajah
raray = muka
rawayan = jembatan
reang = riuh
receh = uang kecil
regot = seruput
rehe = rese
rek = akan
rencang = teman
rengkog = berhenti tiba-tiba
rengkuh = hormat
rengse = selesai
repeh = hening
reueuk = awan
reueus = bangga
reuma = jari
reuneuh = hamil
reungit = nyamuk
reuwas = terkejut
rewog = lahap
reyod = reot
rikrik = hemat
ringkes = ringkas
ringkid = bawa
ririwa = hantu
rohangan = ruangan
rompo = jompo
rompo = renta
rorompok = rumah
ruhay = bara api
ruksak = rusak
rumaos = merasa
rumbah = kumis
rungsing = ruwet
runtah = sampah
rupa = macam
rupa = jenis
rupa-rupa = aneka
rupi = macam
rupi = jenis
rusiah = rahasia
rusuh = terburu-buru
sabalikna = sebaliknya
sabaraha = berapa
sabet = sambit
sadaya = semua
saderek = saudara
sae = bagus
saeutik = sedikit
saha = siapa
sajabina = kecil
sakalor = ayan
saladah = seladah
salaki = suami
salapan = sembilan
salatu = uban
salawe = dua puluh lima
salempang = kuatir
salira = badan
samak = tikar
sambel = sambal
sami = sama
sampak = sudah ada
sampean = kaki
sampeur = ajak
sampurasun = permisi
sanes = bukan
sanggem = sanggup
sangka = duga
sangki = duga
sapagodos = setuju
sapalih = sebagian
sapatu = sepatu
sapertos = seperti
saprak = semenjak
sapuluh = sepuluh
sarakah = serakah
sare = tidur
sarebu = seribu
sareng = dengan
sarimbit = sekeluarga
sarua = sama
sarupaning = semacam
sasab = tersesat
sasak = jembatan
sasapu = menyapu
sasih = bulan
satia = setia
sato = binatang
saung = gubuk
saur = kata
sawang = bayang
sawareh = sebagian
sayang = sarang
sayogi = sedia
sebat = sebut
seep = habis
segut = semangat
sejen = lainnya
selap = sisip
semah = tamu
sendal = sendal
sentak = gertak
sentak = hardik
sepen = kamar tidur
sepuh = tua
serab = silau
serat = surat
seren = serah
sering = kerap
sesa = sisa
sesah = susah
seubeuh = kenyang
seueur = banyak
seukeut = tajam
seuneu = api
seungit = wangi
seungit = harum
seupah = ampas
seupan = kukus
seureud = sengat
seureuh = sirih
seuri = senyum
seuri = tertawa
seuseup = hisap
sia = kamu
siang = siang
sieun = takut
siga = seperti
sihung = taring
siki = biji
siluman = hantu
simeut = belalang
simpang = mampir
simpe = sunyi
simpen = simpan
sinareng = dengan
sindang = mampir
sirah = kepala
siram = mandi
sireum = semut
sirik = iri
situ = danau
situ = telaga
soak = kaget
soang = angsa
sobat = sahabat
soca = mata
sologoto = ceroboh
solokan = parit
someah = ramah-tamah
sono = rindu
sonten = sore
sora = suara
soweh = sobek
sowek = sobek
suan = keponakan
sugan = jika
suku = kaki
sumanget = semangat
sumping = datang
sumping = tiba
sumuhun = iya betul
sungut = mulut
supa = jamur
supata = sumpah
surak = sorak
sureum = kabur
susu = payudara
susukan = sungai
taar = dahi
taar = jidat
tabuh = jam
tajug = surau
taktak = pundak
talaga = danau
talaga = telaga
taliti = cermat
tambelar = durhaka
tambih = tambah
tamper = endap
tampik = tolak
tampiling = tampar
tamu = tamu
taneuh = tanah
tanggara = kabar
tanggay = kuku
tangkal = pohon
tangkeup = rangkul
tangkub = tengkurap
tanpadaksa = cacat
tapak = jejak
taraje = tangga bambu
taraju = bahu
tarang = jidat
tarang = dahi
tarekah = usaha
tarik = keras
tarik = cepat
taros = tanya
tarumpah = sandal
tatamu = tamu
tatangga = tetangga
tatanggi = tetangga
tatih = berdiri
tatu = luka
taun = tahun
taun = tahun
tawis = tanda
teang = cari
tebih = jauh
tegal = lapang
tegalan = tanah lapang
tehel = tegel
teke = jitak
tembang = lagu
tembong = kelihatan
tempo = lihat
tengek = leher
tengen = kanan
tengtrem = damai
tenjo = lihat
tepang = jumpa
tepas = teras
tepung = jumpa
terang = tau
teras = kemudian
tere = tiri
teteh = kakak perempuan
teu = tidak
teuas = keras
teuing = tidak tau
teuleum = selam
teuneung = berani
teunggeul = pukul
ti = dari
tiasa = bisa
tihang = tiang
tiis = dingin
tijalikeuh = terpeleset
tikoro = tenggorokan
tilar dunya = meninggal dunia
tilas = bekas
tilik = teliti
tilu = tiga
timanten = dari mana
timburu = cemburu
tincak = injak
tinggal = lihat
tipung = tepung
tiris = dingin
tisaprak = sejak
tisaprak = semenjak
tisoleda = terpeleset
titadi = dari tadi
tiwu = tebu
tojos = tusuk
tonggoh = tempat di atas
tonggong = punggung
torek = tuli
torowongan = terowongan
tuang = makan
tuar = tebang
tubruk = tabrak
tujuh = tujuh
tukang = belakang
tulale = belalai
tulung = tolong
tumbak = tombak
tumbila = kutu busuk
tunduh = kantuk
tunduh = mengantuk
tundung = usir
tunggara = sedih
tunggara = merana
tungtung = ujung
tutung = hangus
tuur = dengkul
tuur = lutut
ucing = kucing
udag = kejar
udur = sakit
ulah = jangan
ulem = undang
ulin = main
umur = usia
unggal = tiap
unggeuk = manggut
ungkluk = wts
uninga = tau
upami = jika
urang = saya
urut = bekas
usik = gerak
utami = utama
uyah = garam
wadul = bohong
wahangan = sungai
wahangan = kali
waja = baja
waktos = waktu
walagri = sehat
waler = jawab
walirang = belerang
walungan = sungai
waluya = sehat
wanara = mo-nyet
wanci = waktu
wangsul = pulang
wangun = bangun
wani = berani
wanoh = kenal
wanoja = gadis
wanoja = remaja
wantun = sanggup
waos = gigi
waragad = biaya
wareg = kenyang
warsi = tahun
wartos = warta
waruga = badan
wasta = nama
wasuh = cuci
watek = watak
wates = batas
wawacan = legenda
wawar = memberi kabar
wawasan = hikayat
wawuh = kenal
wayah = waktu
wedak = bedak
weduk = kebal
wegah = enggan
welas = sayang
wengi = malam
wetan = timur
wetis = betis
weuteuh = baru
widang = bidang
widi = ijin
wijaksana = bijaksana
wilangan = bilangan
wilujeng = selamat
wilujeng enjing = selamat pagi
wilujeng siang = selamat siang
wilujeng sonten = selamat sore
wilujeng wengi = selamat malam
winojakrama = lomba
wios = biar
wungkul = hanya
wungkul = saja
wuruk = mengajar
wuwung = atap
yen = bahwa
yuswa = usia
